0000000000
0000110000
0011221100
0222112220
0011221100
0000110000
0000000000
0000000000
0000000000
0000000000
0000000000
0000000000