0000000000
011110000
0100000000
010110000
0100100000
0111100000
0000001111
0000001001
0000001001
0000001001
0000001111
0000000000