0000000000
0022002200
0022002200
0211111110
0211111110
0021111100
0021111100
0002111000
0002112000
0000220000
0000220000
0000000000
